x x x x x x x x x x x x
x       x             x
x    p  x      m      x
x       x             x
x                     x
x                     x
x    m         r      x
x                     x
x                     x
x                m    x
x    r                x
x x x x x x x x x x x x
