x x x x x x x x x x x x x x x x x x x x
x                                     x
x                    m                x 
x      p                    x x x     x
x                           x  rx     x
x                m          x x x     x
x                                     x
x                          r          x
x                                     x
x     x x x  m              x x x     x
x     x  rx              m  x  rx     x
x     x x x                 x x x     x
x                  r                  x
x                                     x
x x x x x x x x x x x x x x x x x x x x
