x x x x x x x x x x x x x x x x x x x x
x  r         r       m     r          x
x      m                       m   r  x
x       x x x x x     x x x x x       x
x       x                     x       x
x  m    x                     x       x
x                                     x
x                  p               m  x
x                                     x
x  r    x                     x       x
x       x                     x       x
x       x x x x x     x x x x x    r  x
x      m                       m      x
x  r         r       m           r    x
x x x x x x x x x x x x x x x x x x x x
